



SO ./textures/Wheat_F       ield.png hhhhhhh

WE ./textures/the_tower_of_babel
C 000,00000000000000000000000000000000000000000000000000,7

NO ./textures/girl_with_a_pearl_earring

EA     888888


F  0,1,90



11111111111111111
      1 
11111
 11111111111111
10W0000111111
1111111111111111
11
101
 11
1
1 1




















