NO     ./textures/girl_with_a_pearl_earring.png  
SO     ./textures/Wheat_Field.png      
WE      ./textures/the_tower_of_babel.png  
EA      ./textures/Mona_Lisa.png

F  155,0,222
C  225,255,255

1111111111111111111111111111
111001111111000000000000111
   1111000001110000000001111111111
 1111000000000000000000001000000011
111111111011000001110000011111111
10000000001100001110011111111111
11111111111101011111100010001
      11111101111111111000111111
11111111111101011101010010001
11000000110101011100000010001
101000110001000N00110000000001
100000000010000000000010010001 
111000001111111111110111100111
11110111011        101101010111
   100011111111111111111111111
   1000111111111111111111111111111       
   11111111111111111111111111