



SO       textures/SO.xpm
WE       textures/new1.xpm
NO       textures/egy.xpm
C        22,       0,        0
EA      textures/wall1.xpm
F         0,       0,     0

        111111111111111 1111           
           1111111111N1    1 
              11111111111 11111                 
             11111111111   111                            
             1           111111                       
           11111111  11111
           11111111 111111                                  1





