SO textures/SO.xpm
WE textures/new1.xpm
NO textures/egy.xpm
EA textures/wall1.xpm


C 45,5,9
F 0,1,90




1111111111     111111
1000000001     111111
1000000001     111111
10000N0001     111111
111111111111111111111

