SO textures/SO.xpm
WE textures/new1.xpm
NO textures/egy.xpm
EA textures/wall1.xpm


C 45,5,9
F 0,1,90




11111111   111111
   11111111110011
111S00000000001
   11111101111
      1000001
       10111
       11111

