SO textures/SO.xpm
WE textures/new1.xpm
NO textures/egy.xpm
EA textures/wall1.xpm


C 45,5,9
F 0,1,90


1111
1N01
11D1
1101
1101
111