SO textures/SO.xpm
WE textures/new1.xpm
NO textures/egy.xpm
EA textures/wall1.xpm


C 45,5,9

F 0,1,90

11111 1111
100N1  1111
11111  1111
