SO Mandatory/textures/SO.xpm
WE Mandatory/textures/new1.xpm
NO Mandatory/textures/egy.xpm
EA Mandatory/textures/wall1.xpm

C 45,5,21

F 0,1,90

1111 11
101111N1
 111 111