



SO       textures/SO.xpm
WE       textures/new1.xpm
NO       textures/egy.xpm
C        22,       0,        0
EA      textures/wall1.xpm
F         0,       0,     0

              11111111111              111111111111                                  
          1111N1111            11111111011                                 
              1111111111 111111       1111111111111          
             11111111111 1111                     11111111111 1111          
             111111111   11111                     111111111   11111        
                     11111111111111                        1 1111111111111            
                                                            1
