SO       textures/SO.xpm
WE       textures/new1.xpm
NO       textures/egy.xpm
EA      textures/wall1.xpm


C        4,       55,255
F         45,       55,     111


1111111111     
1000111001       
10000DN101       
1010110001       
111011011           
1110110111          
1000000001     
1111111111  







