SO textures/black.xpm
WE textures/text.xpm
NO textures/black1.xpm
EA textures/outwall.xpm


F 41,49,72
C 117,141,181

   111     1111111111111111111111
11100011111110000000000001
   111100000111000000001111111111
 1111000000000000000000001000000011
111111111011000001110000011111111
100000000011000001110111111111111
1111111111110101111110010001
      1111110111  1 111100011
11111111111101011101010010001
110000001101010111000000100011111111111111111111
101000000000000001100000000000000000000000000001
101000000000000001100000000000000000000000000001
1010000000000000000000000000000000000000000000011111111
1010000000000000011N100000000000000000000000000000000001
1010000000000000011D10000000000000000000000000011111111
101000000000000001101000000000000000000000000001
110000001101010111001000100011111111111111111111
101000000000000001100000000001
10000000000000000000010010001
110000011101111111110111100111
10000000110101011100000010001
100000000000000001100000000001
10000000000000000000010010001
110000011101111111110111100111
11110001011        101101010111
   1000111111111111111111111111
   1000111111111111111111111111
   1000111111111111111111111111
   11111