SO       textures/SO.xpm
WE        textures/new1.xpm
NO        textures/egy.xpm
EA       textures/wall1.xpm


C        4,       55,     8
F         45,       55,     111




111111111    111111
100000001     111111
10000W111     111111
100001     111111
1111111111111111111
       111    11111
        111 11
        111 111

