S O       textures/SO.xpm
WE       textures/new1.xpm
NO       textures/egy.xpm
EA      textures/wall1.xpm


C        4,       55,255
F         45,       55,     111


1111111111
1000111001
100001N101       
1000101001       
111111111           
1111111111          
1000100001 
1111111111  







