
SO        textures/SO.xpm
WE             textures/new1.xpm
NO       textures/egy.xpm
EA           textures/wall1.xpm

C     0,0,0
F     220,     100,       4

11111111111111111111111111111
10000011111110000000000001
1111000001110000000001111111111
 11110000000000000000001000000011
111111111011000001110000011111111
100000000011000001110011111111111
11111111111101011111100010001
      1111110111111111100011111
11111111111101011101010010001
11000000110101011100000010001
101000110000000001100000000001
10000000000000000000010010001
110000011101111111110111100111
11110111011        10110101000111
   10N0111111111111111111111111
   100000111111111111111111111111
   1111111111111111111111111111
   1111111111111111111111111111