



SO       textures/SO.xpm
WE       textures/new1.xpm
NO       textures/egy.xpm
C        22,       0,        0
EA      textures/wall1.xpm
F         0,       0,     0

        1111111111111111111 111  
       1000000000000001    111N1  
        111111111111111    1111





