SO textures/SO.xpm
WE textures/new1.xpm
NO textures/egy.xpm
EA textures/wall1.xpm


C 45,5,9
F 0,1,90


1111111111
1000000001
1000D0N001
1000D00001
1000000001
1111111111