SO textures/SO.xpm
WE textures/new.xpm
NO textures/egy.xpm
EA textures/wall1.xpm


C 45,5,9
F 0,1,90


111111111
111111001
1DDDDD0W1
111111111