F 41,49,72
C 117,141,181

SO textures/black.xpm
WE textures/text.xpm
NO textures/black1.xpm
EA textures/outwall.xpm

   111     1111111111111111111111
11100011111110000000000001
   111100000111000000001111111111
 1111000000000000000000001000000011
111111111011000001110000011111111
100000000011000001110111111111111
1111111111110101111110010001
      1111110111  1 11D100011
111111111111D1011101010010001
11000000110101011100000010001111111111111111111111
101000000000000001100000000010000000000000000000011
10100000000000000110000000001D1D11D11111D111111D1111
101000000000000000000000000000000000000000000000000111111
1010000000000000011N1000000000000000000000000000000D000001
1010000000000000011D1000000000000000000001D11111111111111
1010000000000000011D100000000000000000000D000001111
110000001101010111001000100011111111111111111111
101000000000000001100000000001
10000000000000000000010010001
110000011101111111110111100111
10000000110101011100000010001
100000000000000001100000000001
10000000000000000000010010001
110000011101111111110111100111
11110001011        101101010111
   1000111111111111111111111111
   1000111111111111111111111111
   1000111111111111111111111111
   11111
